1111111111111111111111111111111111111111111111111111111111111111
1111111111111111111111111111111111111111111111111111111111111111
1111143153214152342345213125134234551423154111342355431111111111
1111111111111111111111111111111111111111111111111111111111111111
1111111111111111111111111111242353211111111111111111111111111111
1111111114125243152431523125345213315514231542343121111111111111
1111111111111111111111111111111111111111125453231111111111111111
3123513152351332151531235411315315312515312344312535123451351432
1111111111111111111111111111111111111111111111111111111111111111
1111114153534153241352314532153315235143111111111111111111111111
1111111111111111111153132412152421354234521352135243215215512351
5123453134512341352312513425142351235123412541523412354153111111
1111111111111111111111111111111111111111111111111111111111111111
1342545214531254514532452135413524512351141353521535232443242451
1111111111111111111111111111111111111111111111111111111111111111
1111111111111111111111111111111111111111111111111111111111111111